################
#      @    #  #
#            XX#
#           #  #
#              #
#              #
#  L     G     #
#  L           #
#  L   G      G#
#              #
#              #
#              #
#    G G G     #
#              #
#C            C#
################
